{
  "stage": [
    [0, 0, 0, 0, 0, 0, 0, 0, 0],
    [0, 1, 1, 1, 0, 1, 0, 1, 0],
    [0, 1, 0, 0, 0, 1, 0, 1, 0],
    [0, 1, 0, 1, 0, 1, 1, 1, 0],
    [0, 1, 0, 1, 0, 0, 0, 1, 0],
    [0, 1, 1, 1, 1, 1, 0, 1, 0],
    [0, 1, 0, 0, 0, 0, 0, 1, 0],
    [0, 1, 1, 1, 1, 1, 1, 1, 0],
    [0, 0, 0, 0, 0, 0, 0, 0, 0]
  ],
  "start": [1, 3],
  "goal": [1, 7]
}