{
  "stage": [
    [0, 0, 0, 0, 0, 0, 0, 0, 0],
    [0, 1, 1, 1, 0, 1, 1, 1, 0],
    [0, 0, 0, 1, 0, 1, 0, 1, 0],
    [0, 1, 1, 2, 0, 1, 0, 1, 0],
    [0, 1, 0, 0, 0, 2, 0, 1, 0],
    [0, 1, 1, 1, 1, 1, 0, 2, 0],
    [0, 1, 1, 1, 1, 1, 0, 1, 0],
    [0, 0, 0, 0, 0, 0, 0, 0, 0]
  ],
  "param": [
    [0, 0, 0, 0, 0, 0, 0, 0, 0],
    [0, 0, 0, 0, 0, 0, 0, 0, 0],
    [0, 0, 0, 0, 0, 0, 0, 0, 0],
    [0, 0, 0, 0, 0, 0, 0, 0, 0],
    [0, 0, 0, 0, 0, 0, 0, 0, 0],
    [0, 0, 0, 0, 0, 0, 0, 0, 0],
    [0, 1, 1, 1, 1, 1, 1, 1, 0],
    [0, 0, 0, 0, 0, 0, 0, 0, 0]
  ],
  "start": [1, 1, "right"],
  "goal": [6, 7],
  "controll": [2, 0],
  "costList": {
    "move": 3,
    "destroy": 5,
    "create": 5,
    "loop": 1,
    "if": 1
  },
  "maxCost": 15,
  "maxStep": 30
}