{
  "stage": [
    
    [0, 0, 0, 0, 0, 0, 0, 0],
    [0, 0, 1, 2, 1, 1, 0, 0],
    [0, 1, 1, 1, 2, 1, 1, 0],
    [0, 0, 1, 1, 1, 2, 1, 0],
    [0, 0, 2, 1, 1, 1, 1, 0],
    [0, 1, 1, 2, 1, 1, 1, 0],
    [0, 0, 1, 1, 2, 1, 0, 0],
    [0, 0, 0, 0, 0, 0, 0, 0]
  ],
  "start": [1, 4, "right"],
  "goal": [2, 3],
  "controll": [0, 0],
  "maxCost": 12
}