{
  "stage": [
    [0, 0, 0, 0, 0, 0, 0, 0, 0, 0],
    [0, 1, 0, 5, 0, 1, 0, 1, 1, 0],
    [0, 6, 0, 1, 0, 1, 4, 1, 1, 0],
    [0, 6, 0, 1, 0, 1, 0, 0, 1, 0],
    [0, 1, 4, 1, 1, 1, 1, 1, 1, 0],
    [0, 1, 0, 1, 0, 1, 0, 1, 0, 0],
    [0, 1, 1, 1, 4, 1, 4, 1, 5, 0],
    [0, 1, 0, 1, 0, 1, 0, 0, 0, 0],
    [0, 0, 0, 0, 0, 0, 0, 0, 0, 0]
  ],
  "param": [
    [0, 0, 0, 0, 0, 0, 0, 0, 0, 0],
    [0, 0, 0, 1, 0, 0, 0, 0, 0, 0],
    [0, 0, 0, 0, 0, 0, 2, 0, 0, 0],
    [0, 1, 0, 0, 0, 0, 0, 0, 0, 0],
    [0, 0, 2, 0, 0, 0, 0, 0, 0, 0],
    [0, 0, 0, 0, 0, 0, 0, 0, 0, 0],
    [0, 0, 0, 0, 4, 0, 2, 0, 0, 0],
    [0, 0, 0, 0, 0, 0, 0, 0, 0, 0],
    [0, 0, 0, 0, 0, 0, 0, 0, 0, 0]
  ],
  "start": [1, 8, "left"],
  "goal": [1, 1],
  "controll": [0, 0],
  "costList": {
    "move": 3,
    "destroy": 5,
    "create": 5,
    "loop": 1,
    "if": 1
  },
  "maxCost": 100
}