{
  "stage": [
    
    [0, 0, 0, 0, 0, 0, 0, 0, 0],
    [0, 1, 1, 2, 1, 1, 1, 1, 0],
    [0, 0, 1, 1, 0, 1, 1, 1, 0],
    [0, 1, 1, 0, 1, 1, 1, 1, 0],
    [0, 1, 1, 1, 1, 1, 1, 2, 0],
    [0, 1, 1, 0, 0, 0, 0, 0, 0],
    [0, 1, 1, 0, 0, 0, 0, 0, 0],
    [0, 1, 0, 0, 0, 0, 0, 0, 0],
    [0, 0, 0, 0, 0, 0, 0, 0, 0]
  ],
  "start": [1, 4, "right"],
  "goal": [1, 1],
  "controll": [0, 0]
}