{
  "stage": [
    
    [0, 0, 0, 0, 0, 0, 0, 0, 0],
    [0, 1, 0, 1, 1, 1, 0, 0, 0],
    [0, 1, 0, 1, 0, 0, 0, 0, 0],
    [0, 1, 0, 1, 3, 2, 1, 1, 0],
    [0, 1, 0, 2, 0, 1, 1, 1, 0],
    [0, 1, 0, 1, 0, 0, 1, 3, 0],
    [0, 1, 1, 3, 0, 1, 0, 2, 0],
    [0, 0, 0, 1, 1, 3, 1, 1, 0],
    [0, 0, 0, 0, 0, 0, 0, 0, 0]
  ],
  "param": [
    [0, 0, 0, 0, 0, 0, 0, 0, 0],
    [0, 0, 0, 0, 0, 0, 0, 0, 0],
    [0, 0, 0, 0, 0, 0, 0, 0, 0],
    [0, 0, 0, 0, 0, 0, 0, 0, 0],
    [0, 0, 0, 0, 0, 0, 0, 0, 0],
    [0, 0, 0, 0, 0, 0, 0, 0, 0],
    [0, 0, 0, 0, 0, 0, 0, 0, 0],
    [0, 0, 0, 0, 0, 0, 0, 0, 0],
    [0, 0, 0, 0, 0, 0, 0, 0, 0]
  ],
  "start": [1, 5, "left"],
  "goal": [1, 1],
  "controll": [0, 0],
  "maxCost": 35
}