{
  "stage": [
    [0, 0, 0, 0, 0, 0, 0, 0, 0],
    [0, 1, 1, 0, 1, 1, 1, 0, 0],
    [0, 0, 1, 2, 1, 2, 1, 0, 0],
    [0, 0, 1, 2, 1, 2, 1, 1, 0],
    [0, 0, 1, 1, 1, 0, 1, 0, 0],
    [0, 1, 1, 1, 0, 0, 1, 1, 0],
    [0, 0, 0, 0, 0, 0, 0, 0, 0]
  ],
  "param": [
    [0, 0, 0, 0, 0, 0, 0, 0, 0],
    [0, 0, 0, 0, 0, 0, 0, 0, 0],
    [0, 0, 0, 0, 0, 0, 0, 0, 0],
    [0, 0, 0, 0, 0, 0, 0, 0, 0],
    [0, 0, 0, 0, 0, 0, 0, 0, 0],
    [0, 0, 0, 0, 0, 0, 0, 0, 0],
    [0, 0, 0, 0, 0, 0, 0, 0, 0]
  ],
  "start": [1, 1, "right"],
  "goal": [3, 7],
  "controll": [5, 0],
  "costList": {
    "move": 3,
    "destroy": 5,
    "create": 5,
    "loop": 1,
    "if": 1
  },
  "maxCost": 63,
  "maxStep": 66,
  "unlocked": [
    "move",
    "destroy",
    "create",
    "loop"
  ],
  "message":"STEP2 まとめ"
}