{
  "stage": [
    
    [0, 0, 0, 0, 0, 0, 0, 0, 0, 0],
    [0, 1, 1, 0, 1, 1, 1, 0, 0, 0],
    [0, 0, 1, 0, 2, 0, 1, 0, 0, 0],
    [0, 0, 1, 2, 1, 0, 1, 2, 1, 0],
    [0, 0, 0, 0, 0, 0, 0, 0, 0, 0]
  ],
  "start": [1, 1, "right"],
  "goal": [3, 8],
  "controll": [0, 0]
}