{
  "stage": [
    [0, 0, 0, 0, 0, 0, 0, 0, 0],
    [0, 0, 0, 0, 9, 9, 9, 2, 0],
    [0, 0, 0, 0, 9, 0, 0, 2, 0],
    [0, 0, 0, 0, 9, 0, 0, 2, 0],
    [0, 9, 9, 9, 3, 0, 1, 2, 0],
    [0, 9, 0, 0, 0, 0, 0, 1, 0],
    [0, 9, 9, 9, 9, 0, 3, 1, 0],
    [0, 0, 0, 0, 1, 0, 0, 0, 0],
    [0, 0, 0, 0, 0, 0, 0, 0, 0]
  ],
  "param": [
    [0, 0, 0, 0, 0, 0, 0, 0, 0],
    [0, 0, 0, 0, 0, 0, 0, 0, 0],
    [0, 0, 0, 0, 0, 0, 0, 0, 0],
    [0, 0, 0, 0, 0, 0, 0, 0, 0],
    [0, 0, 0, 0, 0, 0, 0, 0, 0],
    [0, 0, 0, 0, 0, 0, 0, 0, 0],
    [0, 0, 0, 0, 0, 0, 0, 0, 0],
    [0, 0, 0, 0, 0, 0, 0, 0, 0],
    [0, 0, 0, 0, 0, 0, 0, 0, 0]
  ],
  "start": [4, 1, "right"],
  "goal": [7, 4],
  "controll": [0, 7] ,
  "costList": {
    "move": 3,
    "destroy": 5,
    "create": 5,
    "loop": 1,
    "if": 1
  },
  "maxCost": 18,
  "maxStep": 20
}