{
  "stage": [
    [0, 0, 0, 0, 0, 0, 0, 0, 0, 0],
    [0, 0, 0, 0, 0, 1, 1, 1, 2, 0],
    [0, 0, 0, 0, 0, 1, 0, 0, 2, 0],
    [0, 0, 0, 0, 0, 1, 0, 0, 2, 0],
    [0, 1, 1, 1, 1, 3, 0, 1, 2, 0],
    [0, 1, 0, 0, 0, 0, 0, 0, 1, 0],
    [0, 1, 0, 3, 1, 1, 0, 3, 1, 0],
    [0, 0, 0, 0, 0, 1, 0, 0, 0, 0],
    [0, 0, 0, 0, 0, 1, 0, 0, 0, 0],
    [0, 0, 0, 0, 0, 0, 0, 0, 0, 0]
  ],
  "param": [
    [0, 0, 0, 0, 0, 0, 0, 0, 0, 0],
    [0, 0, 0, 0, 0, 0, 0, 0, 0, 0],
    [0, 0, 0, 0, 0, 0, 0, 0, 0, 0],
    [0, 0, 0, 0, 0, 0, 0, 0, 0, 0],
    [0, 0, 0, 0, 0, 0, 0, 0, 0, 0],
    [0, 0, 0, 0, 0, 0, 0, 0, 0, 0],
    [0, 0, 0, 0, 0, 0, 0, 0, 0, 0],
    [0, 0, 0, 0, 0, 0, 0, 0, 0, 0],
    [0, 0, 0, 0, 0, 0, 0, 0, 0, 0],
    [0, 0, 0, 0, 0, 0, 0, 0, 0, 0]
  ],
  "start": [4, 1, "right"],
  "goal": [8, 5],
  "controll": [0, 8] ,
  "costList": {
    "move": 3,
    "destroy": 5,
    "create": 5,
    "loop": 1,
    "if": 1
  },
  "maxCost": 18,
  "maxStep": 20,
  "unlocked": [
    "move",
    "destroy",
    "create",
    "loop",
    "if",
    "sensor_loop",
    "sensor_foot_dest",
    "sensor_foot_stab",
    "sensor_foot_floor"
  ]
}