{
  "stage": [
    
    [0, 0, 0, 0, 0, 0, 0, 0, 0, 0, 0],
    [0, 0, 0, 1, 1, 1, 1, 1, 1, 0, 0],
    [0, 0, 1, 1, 2, 2, 0, 0, 0, 0, 0],
    [0, 0, 1, 1, 1, 1, 1, 1, 1, 1, 0],
    [0, 1, 2, 2, 2, 1, 0, 0, 0, 1, 0],
    [0, 1, 1, 1, 1, 1, 1, 1, 1, 1, 0],
    [0, 1, 0, 0, 0, 0, 0, 0, 0, 0, 0],
    [0, 0, 0, 0, 0, 0, 0, 0, 0, 0, 0]
  ],
  "start": [1, 8, "left"],
  "goal": [6, 1],
  "controll": [1, 0],
  "maxCost": 35
}