{
  "stage": [
    [0, 0, 0, 0, 0, 0, 0, 0],
    [0, 1, 0, 0, 0, 0, 0, 0],
    [0, 1, 9, 9, 9, 9, 4, 0],
    [0, 0, 0, 0, 0, 6, 4, 0],
    [0, 1, 1, 1, 3, 2, 1, 0],
    [0, 1, 2, 1, 2, 1, 1, 0],
    [0, 1, 5, 2, 3, 1, 5, 0],
    [0, 1, 1, 6, 1, 1, 1, 0],
    [0, 0, 0, 0, 0, 0, 0, 0]
  ],
  "param": [
    [0, 0, 0, 0, 0, 0, 0, 0],
    [0, 0, 0, 0, 0, 0, 0, 0],
    [0, 0, 0, 0, 0, 0, 1, 0],
    [0, 0, 0, 0, 0, 0, 1, 0],
    [0, 0, 0, 0, 0, 0, 0, 0],
    [0, 0, 0, 0, 0, 0, 0, 0],
    [0, 0, 0, 0, 0, 0, 1, 0],
    [0, 0, 0, 1, 0, 0, 0, 0],
    [0, 0, 0, 0, 0, 0, 0, 0]
  ],
  "start": [2, 1, "right"],
  "goal": [1, 1],
  "controll": [0, 0],
  "costList": {
    "move": 3,
    "destroy": 5,
    "create": 5,
    "loop": 1,
    "if": 1
  },
  "maxCost": 20
}