{
  "stage": [
    
    [0, 0, 0, 0, 0, 0, 0, 0, 0, 0],
    [0, 0, 0, 1, 1, 1, 2, 1, 0, 0],
    [0, 1, 1, 1, 0, 0, 2, 1, 0, 0],
    [0, 1, 0, 0, 0, 0, 0, 1, 1, 0],
    [0, 1, 0, 0, 0, 0, 0, 0, 0, 0],
    [0, 1, 0, 1, 1, 1, 1, 1, 0, 0],
    [0, 1, 1, 1, 0, 1, 2, 1, 1, 0],
    [0, 0, 0, 0, 0, 0, 1, 1, 0, 0],
    [0, 0, 0, 0, 0, 0, 0, 0, 0, 0]
  ],
  "start": [3, 8, "left"],
  "goal": [6, 8],
  "controll": [0, 6],
  "maxCost": 16
}