{
  "stage": [
    
    [0, 0, 0, 0, 0, 0, 0, 0, 0, 0, 0, 0, 0],
    [0, 0, 1, 3, 0, 1, 1, 3, 0, 1, 1, 0, 0],
    [0, 0, 2, 2, 0, 1, 0, 0, 1, 0, 0, 1, 0],
    [0, 0, 1, 3, 0, 1, 1, 0, 0, 1, 1, 1, 0],
    [0, 0, 1, 2, 1, 0, 1, 0, 3, 0, 0, 1, 0],
    [0, 0, 2, 0, 1, 0, 3, 2, 2, 0, 0, 2, 0],
    [0, 0, 1, 3, 0, 1, 0, 0, 1, 1, 1, 1, 0],
    [0, 1, 1, 0, 0, 0, 1, 1, 1, 0, 0, 0, 0],
    [0, 0, 0, 0, 0, 0, 0, 0, 0, 0, 0, 0, 0]
  ],
  "param": [
    [0, 0, 0, 0, 0, 0, 0, 0, 0, 0, 0, 0, 0],
    [0, 0, 0, 0, 0, 0, 0, 0, 0, 0, 0, 0, 0],
    [0, 0, 0, 0, 0, 0, 0, 0, 0, 0, 0, 0, 0],
    [0, 0, 0, 0, 0, 0, 0, 0, 0, 0, 0, 0, 0],
    [0, 0, 0, 0, 0, 0, 0, 0, 0, 0, 0, 0, 0],
    [0, 0, 0, 0, 0, 0, 0, 0, 0, 0, 0, 0, 0],
    [0, 0, 0, 0, 0, 0, 0, 0, 0, 0, 0, 0, 0],
    [0, 0, 0, 0, 0, 0, 0, 0, 0, 0, 0, 0, 0],
    [0, 0, 0, 0, 0, 0, 0, 0, 0, 0, 0, 0, 0]
  ],
  "start": [7, 1, "right"],
  "goal": [2, 11],
  "controll": [0, 0] ,
  "costList": {
    "move": 3,
    "destroy": 5,
    "create": 5,
    "loop": 1,
    "if": 1
  },
  "maxCost": 30,
  "maxStep": 30,
  "unlocked": [
    "move",
    "destroy",
    "create",
    "loop",
    "if",
    "sensor_loop",
    "sensor_foot_dest",
    "sensor_foot_stab",
    "sensor_foot_floor"
  ],
  "message":"チャレンジ問題⑥"
}