{
  "stage": [
    [0, 0, 0, 0, 0, 0, 0, 0, 0, 0],
    [0, 0, 0, 2, 1, 1, 1, 1, 1, 0],
    [0, 0, 0, 2, 0, 1, 0, 1, 1, 0],
    [0, 0, 0, 2, 0, 1, 1, 1, 2, 0],
    [0, 1, 1, 2, 0, 0, 1, 0, 1, 0],
    [0, 0, 0, 0, 0, 0, 0, 0, 0, 0]
  ],
  "param": [
    [0, 0, 0, 0, 0, 0, 0, 0, 0, 0],
    [0, 0, 0, 0, 0, 0, 0, 0, 0, 0],
    [0, 0, 0, 0, 0, 0, 0, 0, 0, 0],
    [0, 0, 0, 0, 0, 0, 0, 0, 0, 0],
    [0, 0, 0, 0, 0, 0, 0, 0, 0, 0],
    [0, 0, 0, 0, 0, 0, 0, 0, 0, 0]
  ],
  "start": [4, 1, "right"],
  "goal": [3, 5],
  "controll": [0, 3],
  "costList": {
    "move": 3
  },
  "maxCost": 100
}