{
  "stage": [
    [0, 0, 0, 0, 0, 0, 0, 0, 0],
    [0, 1, 1, 1, 2, 1, 1, 1, 0],
    [0, 0, 0, 0, 0, 0, 0, 0, 0]
  ],
  "param": [
    [0, 0, 0, 0, 0, 0, 0, 0, 0],
    [0, 0, 0, 0, 0, 0, 0, 0, 0],
    [0, 0, 0, 0, 0, 0, 0, 0, 0]
  ],
  "start": [1, 1, "right"],
  "goal": [1, 7],
  "controll": [0, 4],
  "costList": {
    "move": 2
  },
  "maxCost": 100,
  "maxStep": 20
}