{
  "stage": [
    [0, 0, 0, 0, 0, 0, 0, 0, 0],
    [0, 0, 0, 0, 0, 2, 1, 1, 0],
    [0, 0, 0, 0, 0, 2, 2, 0, 0],
    [0, 1, 1, 0, 0, 2, 2, 0, 0],
    [0, 0, 1, 0, 0, 2, 2, 0, 0],
    [0, 0, 1, 0, 0, 2, 2, 0, 0],
    [0, 0, 1, 1, 1, 1, 2, 1, 0],
    [0, 0, 0, 0, 0, 0, 0, 0, 0]
  ],
  "param": [
    [0, 0, 0, 0, 0, 0, 0, 0, 0],
    [0, 0, 0, 0, 0, 0, 0, 0, 0],
    [0, 0, 0, 0, 0, 0, 0, 0, 0],
    [0, 0, 0, 0, 0, 0, 0, 0, 0],
    [0, 0, 0, 0, 0, 0, 0, 0, 0],
    [0, 0, 0, 0, 0, 0, 0, 0, 0],
    [0, 0, 0, 0, 0, 0, 0, 0, 0],
    [0, 0, 0, 0, 0, 0, 0, 0, 0]
  ],
  "start": [3, 1, "right"],
  "goal": [1, 7],
  "controll": [6, 8],
  "costList": {
    "move": 3,
    "destroy": 5,
    "create": 5,
    "loop": 1,
    "if": 1
  },
  "maxCost": 72,
  "maxStep": 63,
  "unlocked": [
    "move",
    "destroy",
    "create",
    "loop",
    "if",
    "sensor_loop",
    "sensor_foot_dest",
    "sensor_foot_stab",
    "sensor_foot_floor"
  ],
  "message":"チャレンジ問題 その1 ⑥"
}