{
    "stage": [
      [0, 0, 0, 0, 0, 0, 0, 0],
      [0, 1, 1, 1, 0, 0, 0, 0],
      [0, 1, 1, 3, 0, 2, 0, 0],
      [0, 0, 0, 2, 0, 3, 0, 0],
      [0, 2, 3, 2, 3, 0, 1, 0],
      [0, 2, 0, 0, 0, 2, 0, 0],
      [0, 2, 0, 0, 2, 3, 0, 0],
      [0, 1, 1, 0, 3, 2, 0, 0],
      [0, 0, 0, 0, 0, 2, 0, 0],
      [0, 0, 0, 0, 0, 0, 0, 0]
    ],
    "param": [
      [0, 0, 0, 0, 0, 0, 0, 0],
      [0, 0, 0, 0, 0, 0, 0, 0],
      [0, 0, 0, 0, 0, 0, 0, 0],
      [0, 0, 0, 0, 0, 0, 0, 0],
      [0, 0, 0, 0, 0, 0, 0, 0],
      [0, 0, 0, 0, 0, 0, 0, 0],
      [0, 0, 0, 0, 0, 0, 0, 0],
      [0, 0, 0, 0, 0, 0, 0, 0],
      [0, 0, 0, 0, 0, 0, 0, 0],
      [0, 0, 0, 0, 0, 0, 0, 0]
    ],
    "start": [1, 1, "right"],
    "goal": [4, 6],
    "controll": [1, 5] ,
    "costList": {
      "move": 3,
      "destroy": 5,
      "create": 5,
      "loop": 1,
      "if": 1
    },
    "maxCost": 100,
    "maxStep": 90,
    "unlocked": [
      "move",
      "destroy",
      "create",
      "loop",
      "if",
      "sensor_loop",
      "sensor_foot_dest",
      "sensor_foot_stab",
      "sensor_foot_floor"
    ],
    "message":"岩をこわす回数をできるだけ少なくしよう"
  }