{
  "stage": [
    
    [0, 0, 0, 0, 0, 0, 0],
    [0, 1, 1, 2, 1, 0, 0],
    [0, 1, 0, 2, 1, 0, 0],
    [0, 1, 0, 0, 1, 1, 0],
    [0, 1, 0, 0, 0, 0, 0],
    [0, 1, 1, 1, 1, 0, 0],
    [0, 0, 1, 2, 1, 1, 0],
    [0, 0, 0, 1, 1, 0, 0],
    [0, 0, 0, 0, 0, 0, 0]
  ],
  "start": [3, 5, "left"],
  "goal": [6, 5],
  "controll": [0, 3],
  "maxCost": 16
}