{
  "stage": [
    [0, 0, 0, 0, 0, 0, 0, 0, 0, 0, 0, 0, 0],
    [0, 1, 1, 1, 1, 1, 1, 1, 1, 1, 0, 1, 0],
    [0, 0, 0, 0, 0, 1, 1, 1, 0, 1, 0, 1, 0],
    [0, 0, 0, 0, 0, 1, 1, 0, 1, 1, 0, 1, 0],
    [0, 0, 0, 0, 0, 0, 0, 1, 1, 1, 0, 1, 0],
    [0, 0, 0, 2, 2, 2, 2, 2, 2, 0, 1, 1, 0],
    [0, 0, 0, 0, 0, 0, 1, 0, 1, 1, 1, 1, 0],
    [0, 0, 0, 0, 0, 0, 1, 4, 4, 0, 1, 1, 0],
    [0, 0, 0, 0, 0, 0, 4, 4, 4, 0, 0, 1, 0],
    [0, 0, 0, 0, 0, 0, 0, 0, 0, 0, 0, 0, 0]
  ],
  "param": [
    [0, 0, 0, 0, 0, 0, 0, 0, 0, 0, 0, 0, 0],
    [0, 0, 0, 0, 0, 0, 0, 0, 0, 0, 0, 0, 0],
    [0, 0, 0, 0, 0, 0, 0, 0, 0, 0, 0, 0, 0],
    [0, 0, 0, 0, 0, 0, 0, 0, 0, 0, 0, 0, 0],
    [0, 0, 0, 0, 0, 0, 0, 0, 0, 0, 0, 0, 0],
    [0, 0, 0, 0, 0, 0, 0, 0, 0, 0, 0, 0, 0],
    [0, 0, 0, 0, 0, 0, 0, 0, 0, 0, 0, 0, 0],
    [0, 0, 0, 0, 0, 0, 0, 0, 1, 0, 0, 0, 0],
    [0, 0, 0, 0, 0, 0, 1, 0, 1, 0, 0, 0, 0],
    [0, 0, 0, 0, 0, 0, 0, 0, 0, 0, 0, 0, 0]
  ],
  "start": [1, 1, "right"],
  "goal": [1, 11],
  "controll": [5, 2],
  "costList": {
    "move": 3,
    "destroy": 5,
    "create": 5,
    "loop": 1,
    "if": 1
  },
  "maxCost": 99,
  "maxStep": 99,
  "unlocked": [
    "move",
    "destroy",
    "create",
    "repair",
    "loop",
    "if",
    "sensor_loop",
    "sensor_foot_dest",
    "sensor_foot_stab",
    "sensor_foot_floor",
    "sensor_foot_colp"
  ],
  "message":"STEP6 まとめ"
}