{
  "stage": [
    [0, 0, 0, 0, 0, 0, 0, 0, 0, 0],
    [0, 0, 1, 0, 0, 0, 0, 0, 0, 0],
    [0, 0, 1, 1, 1, 1, 1, 5, 0, 0],
    [0, 0, 2, 5, 1, 0, 0, 1, 0, 0],
    [0, 1, 6, 2, 1, 1, 5, 1, 1, 0],
    [0, 1, 6, 1, 1, 1, 1, 1, 5, 0],
    [0, 0, 0, 0, 0, 0, 0, 0, 0, 0]
  ],
  "param": [
    [0, 0, 0, 0, 0, 0, 0, 0, 0, 0],
    [0, 0, 0, 0, 0, 0, 0, 0, 0, 0],
    [0, 0, 0, 0, 0, 0, 0, 0, 0, 0],
    [0, 0, 0, 0, 0, 0, 0, 0, 0, 0],
    [0, 0, 1, 0, 0, 0, 1, 0, 0, 0],
    [0, 0, 0, 0, 0, 0, 0, 0, 0, 0],
    [0, 0, 0, 0, 0, 0, 0, 0, 0, 0]
  ],
  "start": [1, 2, "front"],
  "goal": [4, 1],
  "controll": [0, 0],
  "costList": {
    "move": 3,
    "destroy": 5,
    "create": 5,
    "loop": 1,
    "if": 1
  },
  "maxCost": 70,
  "maxStep": 81,
  "unlocked": [
    "move",
    "destroy",
    "create",
    "repair",
    "loop",
    "if",
    "sensor_loop",
    "sensor_foot_dest",
    "sensor_foot_stab",
    "sensor_foot_floor",
    "sensor_foot_colp"
  ],
  "message":"キャラクターをゴールまで導こう"
}