{
  "stage": [
    [0, 0, 0, 0, 0, 0, 0, 0],
    [0, 1, 1, 1, 1, 2, 1, 0],
    [0, 0, 2, 0, 1, 0, 1, 0],
    [0, 1, 1, 1, 2, 1, 1, 0],
    [0, 0, 0, 0, 0, 0, 0, 0]
  ],
  "param": [
    [0, 0, 0, 0, 0, 0, 0, 0],
    [0, 0, 0, 0, 0, 0, 0, 0],
    [0, 0, 0, 0, 0, 0, 0, 0],
    [0, 0, 0, 0, 0, 0, 0, 0],
    [0, 0, 0, 0, 0, 0, 0, 0]
  ],
  
  "start": [1, 1, "right"],
  "goal": [3, 3],
  "controll": [0, 0],
  "costList": {
    "move": 3,
    "destroy": 5,
    "create": 5,
    "loop": 1,
    "if": 1
  },
  "maxCost": 15,
  "maxStep": 20
  
}