{
  "stage": [
    [0, 0, 0, 0, 0, 0, 0, 0, 0, 0, 0, 0],
    [0, 1, 2, 4, 2, 4, 2, 4, 2, 4, 2, 0],
    [0, 0, 0, 0, 0, 0, 0, 0, 0, 0, 4, 0],
    [0, 0, 0, 0, 0, 0, 0, 0, 0, 0, 2, 0],
    [0, 1, 4, 2, 4, 2, 4, 2, 4, 2, 4, 0],
    [0, 0, 0, 0, 0, 0, 0, 0, 0, 0, 0, 0]
  ],
  "param": [
    [0, 0, 0, 0, 0, 0, 0, 0, 0, 0, 0, 0],
    [0, 0, 0, 0, 0, 0, 0, 0, 0, 0, 0, 0],
    [0, 0, 0, 0, 0, 0, 0, 0, 0, 0, 0, 0],
    [0, 0, 0, 0, 0, 0, 0, 0, 0, 0, 0, 0],
    [0, 0, 0, 0, 0, 0, 0, 0, 0, 0, 0, 0],
    [0, 0, 0, 0, 0, 0, 0, 0, 0, 0, 0, 0]
  ],
  "start": [1, 1, "right"],
  "goal": [4, 1],
  "controll": [0, 2],
  "costList": {
    "move": 3,
    "destroy": 5,
    "create": 5,
    "loop": 1,
    "if": 1
  },
  "maxCost": 72,
  "maxStep": 66,
  "unlocked": [
    "move",
    "destroy",
    "create",
    "repair",
    "loop",
    "if",
    "sensor_loop",
    "sensor_foot_dest",
    "sensor_foot_stab",
    "sensor_foot_floor",
    "sensor_foot_colp"
  ],
  "message":"チャレンジ問題 その2 ④"
}