{
  "stage": [
    [0, 0, 0, 0, 0, 0, 0, 0],
    [0, 1, 6, 1, 4, 1, 4, 0],
    [0, 0, 0, 0, 4, 4, 4, 0],
    [0, 1, 3, 0, 1, 4, 4, 0],
    [0, 1, 1, 1, 1, 4, 4, 0],
    [0, 1, 1, 1, 1, 4, 4, 0],
    [0, 1, 2, 1, 1, 4, 4, 0],
    [0, 0, 0, 0, 4, 4, 5, 0],
    [0, 0, 0, 0, 0, 0, 0, 0]
  ],
  "param": [
    [0, 0, 0, 0, 0, 0, 0, 0],
    [0, 0, 0, 0, 1, 0, 1, 0],
    [0, 0, 0, 0, 1, 1, 1, 0],
    [0, 0, 0, 0, 0, 1, 1, 0],
    [0, 0, 0, 0, 0, 1, 1, 0],
    [0, 0, 0, 0, 0, 1, 1, 0],
    [0, 0, 0, 0, 0, 1, 1, 0],
    [0, 0, 0, 0, 1, 1, 0, 0],
    [0, 0, 0, 0, 0, 0, 0, 0]
  ],
  "start": [1, 5, "right"],
  "goal": [1, 1],
  "controll": [0, 0],
  "costList": {
    "move": 3,
    "destroy": 5,
    "create": 5,
    "loop": 1,
    "if": 1
  },
  "maxCost": 72,
  "maxStep": 105,
  "unlocked": [
    "move",
    "destroy",
    "create",
    "repair",
    "loop",
    "if",
    "sensor_loop",
    "sensor_foot_dest",
    "sensor_foot_stab",
    "sensor_foot_floor",
    "sensor_foot_colp"
  ],
  "message":"チャレンジ問題 その2 ⑥"
}