{
  "stage": [
    [0, 0, 0, 0, 0, 0, 0, 0, 0, 0],
    [0, 1, 0, 5, 0, 1, 0, 1, 1, 0],
    [0, 6, 0, 1, 0, 2, 4, 1, 1, 0],
    [0, 6, 0, 1, 0, 1, 0, 0, 1, 0],
    [0, 1, 4, 1, 1, 2, 1, 1, 1, 0],
    [0, 1, 0, 1, 0, 1, 0, 1, 0, 0],
    [0, 1, 1, 1, 4, 2, 4, 1, 5, 0],
    [0, 1, 2, 1, 2, 1, 0, 0, 0, 0],
    [0, 0, 0, 0, 0, 0, 0, 0, 0, 0]
  ],
  "param": [
    [0, 0, 0, 0, 0, 0, 0, 0, 0, 0],
    [0, 0, 0, 1, 0, 0, 0, 0, 0, 0],
    [0, 0, 0, 0, 0, 0, 2, 0, 0, 0],
    [0, 1, 0, 0, 0, 0, 0, 0, 0, 0],
    [0, 0, 2, 0, 0, 0, 0, 0, 0, 0],
    [0, 0, 0, 0, 0, 0, 0, 0, 0, 0],
    [0, 0, 0, 0, 2, 0, 2, 0, 0, 0],
    [0, 0, 0, 0, 0, 0, 0, 0, 0, 0],
    [0, 0, 0, 0, 0, 0, 0, 0, 0, 0]
  ],
  "start": [1, 8, "left"],
  "goal": [1, 1],
  "controll": [0, 0],
  "maxCost": 90,
  "maxStep": 120,
  "unlocked": [
    "move",
    "destroy",
    "create",
    "repair",
    "loop",
    "if",
    "sensor_loop",
    "sensor_foot_dest",
    "sensor_foot_stab",
    "sensor_foot_floor",
    "sensor_foot_colp"
  ],
  "message":"チャレンジ問題 その2 ⑧"
}