{
  "stage": [
    [0, 0, 0, 0, 0, 0, 0, 0, 0],
    [0, 0, 0, 0, 2, 1, 1, 1, 0],
    [0, 1, 1, 1, 0, 1, 0, 0, 0],
    [0, 1, 1, 1, 1, 1, 1, 0, 0],
    [0, 1, 1, 1, 1, 0, 1, 0, 0],
    [0, 0, 0, 0, 2, 0, 1, 0, 0],
    [0, 0, 1, 1, 2, 1, 1, 0, 0],
    [0, 0, 1, 0, 0, 0, 0, 0, 0],
    [0, 0, 1, 1, 2, 1, 1, 1, 0],
    [0, 0, 0, 0, 0, 0, 0, 0, 0]
  ],
  "param": [
    [0, 0, 0, 0, 0, 0, 0, 0, 0],
    [0, 0, 0, 0, 0, 0, 0, 0, 0],
    [0, 0, 0, 0, 0, 0, 0, 0, 0],
    [0, 0, 0, 0, 0, 0, 0, 0, 0],
    [0, 0, 0, 0, 0, 0, 0, 0, 0],
    [0, 0, 0, 0, 0, 0, 0, 0, 0],
    [0, 0, 0, 0, 0, 0, 0, 0, 0],
    [0, 0, 0, 0, 0, 0, 0, 0, 0],
    [0, 0, 0, 0, 0, 0, 0, 0, 0],
    [0, 0, 0, 0, 0, 0, 0, 0, 0]
  ],
  "start": [1, 7, "left"],
  "goal": [8, 7],
  "controll": [0, 4],
  "costList": {
    "move": 3,
    "destroy": 5,
    "create": 5,
    "loop": 1,
    "if": 1
  },
  "maxCost": 90,
  "maxStep": 99,
  "unlocked": [
    "move",
    "destroy",
    "create",
    "repair",
    "loop",
    "twoif",
    "sensor_loop",
    "sensor_loop_multiple",
    "sensor_foot_dest",
    "sensor_foot_stab",
    "sensor_foot_floor",
    "sensor_foot_colp",
    "sensor_foot_spring"
  ],
  "message":"足元が岩であるかつ,くりかえしが2の倍数である\nたびに岩をこわし,そうでないときに岩を置こう"
}