{
  "stage": [
    [0, 0, 0, 0, 0, 0, 0, 0],
    [0, 1, 1, 1, 1, 2, 0, 0],
    [0, 0, 1, 0, 2, 1, 0, 0],
    [0, 0, 0, 2, 0, 1, 1, 0],
    [0, 0, 0, 0, 0, 0, 1, 0],
    [0, 0, 0, 0, 0, 0, 1, 0],
    [0, 0, 0, 1, 2, 1, 1, 0],
    [0, 0, 1, 2, 0, 0, 0, 0],
    [0, 0, 2, 0, 0, 0, 0, 0],
    [0, 0, 1, 0, 0, 0, 0, 0],
    [0, 0, 0, 0, 0, 0, 0, 0]
  ],
  "param": [
    [0, 0, 0, 0, 0, 0, 0, 0],
    [0, 0, 0, 0, 0, 0, 0, 0],
    [0, 0, 0, 0, 0, 0, 0, 0],
    [0, 0, 0, 0, 0, 0, 0, 0],
    [0, 0, 0, 0, 0, 0, 0, 0],
    [0, 0, 0, 0, 0, 0, 0, 0],
    [0, 0, 0, 0, 0, 0, 0, 0],
    [0, 0, 0, 0, 0, 0, 0, 0],
    [0, 0, 0, 0, 0, 0, 0, 0],
    [0, 0, 0, 0, 0, 0, 0, 0],
    [0, 0, 0, 0, 0, 0, 0, 0]
  ],
  "start": [1, 1, "right"],
  "goal": [9, 2],
  "controll": [0, 6],
  "costList": {
    "move": 3,
    "destroy": 5,
    "create": 5,
    "loop": 1,
    "if": 1
  },
  "maxCost": 88,
  "maxStep": 63,
  "unlocked": [
    "move",
    "destroy",
    "create",
    "repair",
    "loop",
    "if",
    "twoif",
    "sensor_loop",
    "sensor_loop_multiple",
    "sensor_foot_dest",
    "sensor_foot_stab",
    "sensor_foot_floor",
    "sensor_foot_colp",
    "sensor_foot_spring"
  ],
  "message":"足元が木であるかつループ3回目以降である\nときに右、そうでないときに左に進もう"
}