{
  "stage": [
    
    [0, 0, 0, 0, 0, 0, 0, 0],
    [0, 0, 1, 2, 1, 1, 0, 0],
    [0, 1, 1, 1, 2, 1, 1, 0],
    [0, 0, 1, 1, 1, 2, 1, 0],
    [0, 0, 2, 1, 1, 1, 1, 0],
    [0, 1, 1, 2, 1, 1, 1, 0],
    [0, 0, 1, 1, 2, 1, 0, 0],
    [0, 0, 0, 0, 0, 0, 0, 0]
  ],
  "param": [
    [0, 0, 0, 0, 0, 0, 0, 0],
    [0, 0, 0, 0, 0, 0, 0, 0],
    [0, 0, 0, 0, 0, 0, 0, 0],
    [0, 0, 0, 0, 0, 0, 0, 0],
    [0, 0, 0, 0, 0, 0, 0, 0],
    [0, 0, 0, 0, 0, 0, 0, 0],
    [0, 0, 0, 0, 0, 0, 0, 0],
    [0, 0, 0, 0, 0, 0, 0, 0]
  ],
  
  "start": [1, 4, "right"],
  "goal": [2, 3],
  "controll": [0, 0],
  "costList": {
    "move": 3,
    "destroy": 5,
    "create": 5,
    "loop": 1,
    "if": 1
  },
  "maxCost": 13,
  "maxStep": 30,
  "unlocked": [
    "move",
    "destroy",
    "create",
    "loop"
  ]
}