{
  "stage": [
    [0, 0, 0, 0, 0, 0, 0, 0, 0],
    [0, 1, 1, 3, 1, 1, 1, 1, 0],
    [0, 1, 0, 0, 0, 0, 0, 0, 0],
    [0, 3, 0, 1, 1, 1, 0, 1, 0],
    [0, 1, 0, 1, 0, 0, 0, 1, 0],
    [0, 1, 1, 4, 1, 1, 0, 1, 0],
    [0, 0, 0, 1, 0, 1, 0, 1, 0],
    [0, 1, 1, 1, 0, 1, 0, 1, 0],
    [0, 0, 0, 0, 0, 0, 0, 0, 0]
  ],
  "param": [
    [0, 0, 0, 0, 0, 0, 0, 0, 0],
    [0, 0, 0, 0, 0, 0, 0, 0, 0],
    [0, 0, 0, 0, 0, 0, 0, 0, 0],
    [0, 0, 0, 0, 0, 0, 0, 0, 0],
    [0, 0, 0, 0, 0, 0, 0, 0, 0],
    [0, 0, 0, 0, 0, 0, 0, 0, 0],
    [0, 0, 0, 0, 0, 0, 0, 0, 0],
    [0, 0, 0, 0, 0, 0, 0, 0, 0],
    [0, 0, 0, 0, 0, 0, 0, 0, 0]
  ],
  "start": [1, 1, "right"],
  "goal": [5, 7],
  "controll": [0, 0]
}