{
  "stage": [
    [0, 0, 0, 0, 0, 0, 0, 0, 0],
    [0, 1, 1, 3, 0, 1, 1, 1, 0],
    [0, 1, 0, 0, 0, 1, 0, 0, 0],
    [0, 1, 0, 1, 1, 1, 1, 1, 0],
    [0, 0, 0, 1, 0, 0, 0, 1, 0],
    [0, 1, 1, 1, 1, 1, 0, 1, 0],
    [0, 0, 0, 1, 0, 1, 0, 0, 0],
    [0, 1, 1, 1, 0, 1, 1, 1, 0],
    [0, 0, 0, 0, 0, 0, 0, 0, 0]
  ],
  "start": [1, 1, "right"],
  "goal": [5, 7],
  "controll": [0, 0]
}