{
  "stage": [
    [0, 0, 0, 0, 0, 0, 0, 0, 0],
    [0, 1, 3, 1, 3, 1, 1, 5, 0],
    [0, 0, 0, 0, 0, 0, 0, 0, 0],
    [0, 1, 0, 1, 1, 9, 0, 1, 0],
    [0, 1, 0, 1, 0, 0, 0, 1, 0],
    [0, 1, 1, 1, 6, 3, 0, 1, 0],
    [0, 0, 0, 1, 0, 1, 0, 1, 0],
    [0, 5, 1, 1, 0, 1, 0, 1, 0],
    [0, 0, 0, 0, 0, 0, 0, 0, 0]
  ],
  "param": [
    [0, 0, 0, 0, 0, 0, 0, 0, 0],
    [0, 0, 0, 5, 1, 2, 0, 0, 0],
    [0, 0, 0, 0, 0, 0, 0, 0, 0],
    [0, 0, 0, 0, 0, 0, 0, 0, 0],
    [0, 0, 0, 0, 0, 0, 0, 0, 0],
    [0, 0, 0, 4, 0, 0, 0, 0, 0],
    [0, 0, 0, 0, 0, 0, 0, 0, 0],
    [0, 0, 0, 0, 0, 0, 0, 0, 0],
    [0, 0, 0, 0, 0, 0, 0, 0, 0]
  ],
  "start": [1, 1, "right"],
  "goal": [1, 6],
  "controll": [3, 5],
  "costList": {
    "move": 2
  },
  "maxCost": 810
}