{
  "stage": [
    [0, 0, 0, 0, 0, 0, 0, 0, 0],
    [0, 1, 1, 1, 1, 4, 1, 5, 0],
    [0, 1, 0, 0, 0, 0, 0, 0, 0],
    [0, 1, 0, 1, 1, 1, 0, 1, 0],
    [0, 1, 0, 1, 0, 0, 0, 1, 0],
    [0, 1, 1, 1, 6, 3, 0, 1, 0],
    [0, 0, 0, 1, 0, 1, 0, 1, 0],
    [0, 5, 1, 1, 0, 1, 0, 1, 0],
    [0, 0, 0, 0, 0, 0, 0, 0, 0]
  ],
  "param": [
    [0, 0, 0, 0, 0, 0, 0, 0, 0],
    [0, 0, 0, 0, 0, 2, 0, 0, 0],
    [0, 0, 0, 0, 0, 0, 0, 0, 0],
    [0, 0, 0, 0, 0, 0, 0, 0, 0],
    [0, 0, 0, 0, 0, 0, 0, 0, 0],
    [0, 0, 0, 4, 0, 0, 0, 0, 0],
    [0, 0, 0, 0, 0, 0, 0, 0, 0],
    [0, 0, 0, 0, 0, 0, 0, 0, 0],
    [0, 0, 0, 0, 0, 0, 0, 0, 0]
  ],
  "start": [1, 1, "right"],
  "goal": [5, 7],
  "controll": [0, 0],
  "costList": {
    "move": 3,
    "destroy": 810,
    "create": 5,
    "loop": 1,
    "if": 1
  },
  "maxCost": 27
}