{
  "stage": [
    [0, 0, 0, 0, 0, 0, 0, 0, 0, 0, 0, 0, 0],
    [0, 0, 1, 1, 1, 0, 0, 0, 0, 0, 0, 1, 0],
    [0, 1, 1, 2, 1, 1, 1, 0, 0, 0, 0, 1, 0],
    [0, 2, 1, 2, 1, 2, 1, 1, 0, 0, 0, 1, 0],
    [0, 0, 2, 0, 2, 0, 2, 1, 2, 1, 0, 1, 0],
    [0, 2, 1, 2, 1, 2, 0, 2, 1, 2, 0, 2, 0],
    [0, 0, 0, 1, 2, 1, 2, 0, 2, 1, 2, 1, 0],
    [0, 0, 0, 0, 0, 1, 1, 2, 0, 2, 1, 0, 0],
    [0, 0, 0, 0, 0, 0, 0, 1, 2, 1, 0, 0, 0],
    [0, 0, 0, 0, 0, 0, 0, 0, 0, 0, 0, 0, 0]
  ],
  "param": [
    [0, 0, 0, 0, 0, 0, 0, 0, 0, 0, 0, 0, 0],
    [0, 0, 0, 0, 0, 0, 0, 0, 0, 0, 0, 0, 0],
    [0, 0, 0, 0, 0, 0, 0, 0, 0, 0, 0, 0, 0],
    [0, 0, 0, 0, 0, 0, 0, 0, 0, 0, 0, 0, 0],
    [0, 0, 0, 0, 0, 0, 0, 0, 0, 0, 0, 0, 0],
    [0, 0, 0, 0, 0, 0, 0, 0, 0, 0, 0, 0, 0],
    [0, 0, 0, 0, 0, 0, 0, 0, 0, 0, 0, 0, 0],
    [0, 0, 0, 0, 0, 0, 0, 0, 0, 0, 0, 0, 0],
    [0, 0, 0, 0, 0, 0, 0, 0, 0, 0, 0, 0, 0],
    [0, 0, 0, 0, 0, 0, 0, 0, 0, 0, 0, 0, 0]
  ],
  "start": [2, 6, "left"],
  "goal": [1, 11],
  "controll": [0, 0],
  "costList": {
    "move": 3,
    "destroy": 5,
    "create": 5,
    "loop": 1,
    "if": 1
  },
  "maxCost": 130,
  "maxStep": 153,
  "unlocked": [
    "move",
    "destroy",
    "create",
    "repair",
    "loop",
    "if",
    "twoif",
    "sensor_loop",
    "sensor_loop_multiple",
    "sensor_foot_dest",
    "sensor_foot_stab",
    "sensor_foot_floor",
    "sensor_foot_colp",
    "sensor_foot_spring"
  ],
  "message":"応用問題➀"
}