{
  "stage": [
    [0, 0, 0, 0, 0, 0, 0, 0, 0, 0, 0, 0, 0],
    [0, 0, 0, 1, 0, 0, 0, 0, 0, 0, 0, 1, 0],
    [0, 1, 1, 4, 1, 1, 0, 1, 1, 0, 1, 2, 0],
    [0, 0, 0, 1, 2, 4, 0, 6, 0, 3, 2, 2, 0],
    [0, 5, 0, 3, 1, 2, 0, 0, 1, 0, 1, 2, 0],
    [0, 3, 1, 0, 4, 0, 3, 2, 0, 1, 0, 2, 0],
    [0, 2, 0, 2, 3, 0, 2, 0, 1, 0, 0, 2, 0],
    [0, 3, 2, 1, 0, 1, 0, 1, 0, 3, 2, 2, 0],
    [0, 2, 1, 2, 1, 1, 2, 0, 1, 1, 2, 2, 0],
    [0, 1, 1, 3, 2, 1, 2, 2, 2, 1, 2, 2, 0],
    [0, 0, 0, 0, 0, 0, 0, 0, 0, 0, 0, 0, 0]
  ],
  "param": [
    [0, 0, 0, 0, 0, 0, 0, 0, 0, 0, 0, 0, 0],
    [0, 0, 0, 0, 0, 0, 0, 0, 0, 0, 0, 0, 0],
    [0, 0, 0, 2, 0, 0, 0, 0, 0, 0, 0, 0, 0],
    [0, 0, 0, 0, 0, 2, 0, 0, 0, 0, 0, 0, 0],
    [0, 0, 0, 0, 0, 0, 0, 0, 0, 0, 0, 0, 0],
    [0, 0, 0, 0, 0, 0, 0, 0, 0, 0, 0, 0, 0],
    [0, 0, 0, 0, 0, 0, 0, 0, 0, 0, 0, 0, 0],
    [0, 0, 0, 0, 0, 0, 0, 0, 0, 0, 0, 0, 0],
    [0, 0, 0, 0, 0, 0, 0, 0, 0, 0, 0, 0, 0],
    [0, 0, 0, 0, 0, 0, 0, 0, 0, 0, 0, 0, 0],
    [0, 0, 0, 0, 0, 0, 0, 0, 0, 0, 0, 0, 0]
  ],
  "start": [2, 1, "right"],
  "goal": [2, 7],
  "controll": [2, 2],
  "costList": {
    "move": 3,
    "destroy": 5,
    "create": 5,
    "loop": 1,
    "if": 1
  },
  "maxCost": 130,
  "maxStep": 130,
  "unlocked": [
    "move",
    "destroy",
    "create",
    "repair",
    "loop",
    "if",
    "twoif",
    "sensor_loop",
    "sensor_loop_multiple",
    "sensor_foot_dest",
    "sensor_foot_stab",
    "sensor_foot_floor",
    "sensor_foot_colp",
    "sensor_foot_spring"
  ],
  "message":"応用問題➃"
}