{
  "stage": [
    
    [0, 0, 0, 0, 0, 0, 0, 0, 0, 0],
    [0, 1, 1, 1, 1, 1, 1, 1, 2, 0],
    [0, 0, 0, 0, 0, 0, 0, 0, 1, 0],
    [0, 2, 1, 1, 1, 1, 2, 0, 1, 0],
    [0, 1, 1, 0, 0, 0, 1, 0, 1, 0],
    [0, 1, 1, 0, 1, 0, 1, 0, 1, 0],
    [0, 1, 1, 0, 2, 1, 2, 0, 1, 0],
    [0, 1, 1, 0, 0, 0, 0, 0, 1, 0],
    [0, 2, 1, 1, 1, 1, 1, 1, 2, 0],
    [0, 0, 0, 0, 0, 0, 0, 0, 0, 0]
  ],
  "start": [1, 1, "right"],
  "goal": [5, 4],
  "controll": [0, 0]
}